s . # # # # # # # # # # # # # # # # # # # # # # # # # # # # # # # # # # # # # # #
. . . . . . . . . . . . . . . . . . . . . . . . . . . . . . . . . . . . . . . . #
# . . . . . . . . . . . . . . . . . . . . . . . . . . . . . . . . . . . . . # . #
# . . . . . . . . . . . . . . . . . . . . . . . . . . . . . . . . . . . . . # . #
# . . . . . . . . . . . . . . . . . . . . . . . . . . . . . . . . . . . . . # . #
# . . . . . . . . . . . . . . . . . . . . . . . . . . . . . . . . . . . . . # . #
# . . . . . . . . . . . . . . . . . . . . . . . . . . . . . . . . . . . . . # . #
# . . . . . . . . . . . . . . . . . . . . . . . . . . . . . . . . . . . . . # . #
# . . . . . . . . . . . . . . . . . . . . . . . . . . . . . . . . . . . . . # . #
# . . . . . . . . . . . . . . . . . . . . . . . . . . . . . . . . . . . . . # . #
# . . . . . . . . . . . . . . . . . . . . . . . . . . . . . . . . . . . . . # . #
# . . . . . . . . . . . . . . . . . . . . . . . . . . . . . . . . . . . . . # . #
# . . . . . . . . . . . . . . . . . . . . . . . . . . . . . . . . . . . . . # . #
# . . . . . . . . . . . . . . . . . . . . . . . . . . . . . . . . . . . . . # . #
# . . . . . . . . . . . . . . . . . . . . . . . . . . . . . . . . . . . . . # . #
# . . . . . . . . . . . . . . . . . . . . . . . . . . . . . . . . . . . . . # . #
# . . . . . . . . . . . . . . . . . . . . . . . . . . . . . . . . . . . . . # . #
# . . . . . . . . . . . . . . . . . . . . . . . . . . . . . . . . . . . . . # . #
# . . . . . . . . . . . . . . . . . . . . . . . . . . . . . . . . . . . . . # . #
# . . . . . . . . . . . . . . . . . . . . . . . . . . . . . . . . . . . . . # . #
# . . . . . . . . . . . . . . . . . . . . . . . . . . . . . . . . . . . . . # . #
# . . . . . . . . . . . . . . . . . . . . . . . . . . . . . . . . . . . . . # . #
# . . . . . . . . . . . . . . . . . . . . . . . . . . . . . . . . . . . . . # . #
# . . . . . . . . . . . . . . . . . . . . . . . . . . . . . . . . . . . . . # . #
# . . . . . . . . . . . . . . . . . . . . . . . . . . . . . . . . . . . . . # . #
# . . . . . . . . . . . . . . . . . . . . . . . . . . . . . . . . . . . . . # . #
# . . . . . . . . . . . . . . . . . . . . . . . . . . . . . . . . . . . . . # . #
# . . . . . . . . . . . . . . . . . . . . . . . . . . . . . . . . . . . . . # . #
# . . . . . . . . . . . . . . . . . . . . . . . . . . . . . . . . . . . . . # . #
# . . . . . . . . . . . . . . . . . . . . . . . . . . . . . . . . . . . . . # . #
# . . . . . . . . . . . . . . . . . . . . . . . . . . . . . . . . . . . . . # . #
# . . . . . . . . . . . . . . . . . . . . . . . . . . . . . . . . . . . . . # . #
# . . . . . . . . . . . . . . . . . . . . . . . . . . . . . . . . . . . . . # . #
# . . . . . . . . . . . . . . . . . . . . . . . . . . . . . . . . . . . . . # . #
# . . . . . . . . . . . . . . . . . . . . . . . . . . . . . . . . . . . . . # . #
# . . . . . . . . . . . . . . . . . . . . . . . . . . . . . . . . . . . . . # . #
# . . . . . . . . . . . . . . . . . . . . . . . . . . . . . . . . . . . . . # . #
# . . . . . . . . . . . . . . . . . . . . . . . . . . . . . . . . . . . . . # . #
# . # # # # # # # # # # # # # # # # # # # # # # # # # # # # # # # # # # # # # . #
# . . . . . . . . . . . . . . . . . . . . . . . . . . . . . . . . . . . . . . . .
# # # # # # # # # # # # # # # # # # # # # # # # # # # # # # # # # # # # # # # . g