# # # # # # # # # # # # # # # # # # # # # # # # # # # # # # # # # # # # # # # # # # # # # # # # # # # # # # # # # # # # # # # # # # # # # # # # # # # # # # # # #
# . # . . . # . . . . . . . . . # . # . . . # . . . . . . . # . # . . . # . . . . . # . . . . . . . # . # . . . . . . . . . # . # . . . . . . . . . . . . . . . s
# . # . # # # # # . # # # # # # # . # . # # # . # . # . # # # . # . # . # # # . # . # . # . # # # # # . # # # # # . # # # . # . # # # # # . # # # . # . # # # . #
# . . . . . . . . . . . . . # . # . . . . . . . # . # . . . . . # . # . . . . . # . # . # . # . # . . . . . # . . . . . # . # . # . . . # . # . . . # . # . # . #
# . # # # . # # # . # # # # # . # # # # # . # # # . # # # . # . # # # # # # # # # . # # # . # . # # # # # . # # # . # # # # # . # . # . # # # # # . # . # . # . #
# . # . . . # . . . . . . . # . # . . . # . # . # . . . # . # . . . . . . . . . . . . . # . . . . . # . # . # . # . . . . . # . # . # . # . . . . . # . . . # . #
# # # # # . # # # # # # # # # . # # # . # # # . # . # # # # # # # # # . # # # # # . # # # . # . # # # . # . # . # . # # # . # . # # # . # # # # # # # # # # # . #
# . . . . . . . . . . . . . . . . . . . . . . . # . . . . . . . # . . . # . . . . . # . . . # . # . . . # . # . . . # . . . # . . . . . . . # . . . # . . . . . #
# # # # # . # . # # # . # . # # # # # # # # # # # # # # # . # . # # # # # # # # # . # # # . # . # . # . # . # . # . # # # . # . # . # # # # # # # . # . # . # # #
# . # . # . # . . . # . # . . . # . # . # . # . . . . . . . # . # . . . . . . . . . . . # . # . . . # . . . . . # . # . . . . . # . . . . . . . . . # . # . . . #
# . # . # . # # # # # . # # # . # . # . # . # # # # # . # # # . # . # # # # # . # # # . # # # # # # # . # . # # # # # # # # # . # # # # # # # . # # # # # . # . #
# . # . . . # . # . . . # . . . . . . . . . . . # . . . . . # . # . . . # . . . # . # . . . # . # . . . # . # . # . # . # . . . # . . . # . . . # . . . . . # . #
# . # # # # # . # . # # # # # . # # # . # . # . # # # . # # # . # . # # # # # . # . # # # . # . # . # # # . # . # . # . # . # . # . # . # . # # # # # . # . # . #
# . # . # . . . # . . . # . # . . . # . # . # . . . . . . . # . # . . . # . # . . . . . # . . . # . # . # . # . . . # . . . # . . . # . # . # . # . . . # . # . #
# . # . # . # # # # # . # . # # # # # . # # # . # # # . # . # # # . # . # . # . # # # # # . # . # . # . # . # . # # # # # # # # # # # # # . # . # . # # # . # # #
# . . . . . . . . . # . # . . . # . # . # . . . # . # . # . # . . . # . . . # . . . # . . . # . . . # . . . . . . . . . # . . . . . # . . . . . # . # . . . . . #
# . # # # . # . # . # # # . # . # . # . # # # . # . # # # # # . # # # . # # # . # # # . # . # # # # # # # # # # # # # . # . # # # # # # # # # # # # # . # # # . #
# . # . . . # . # . # . . . # . # . . . # . . . . . . . # . . . # . . . . . # . # . . . # . . . # . . . # . . . . . . . . . # . # . . . . . . . # . . . # . . . #
# # # . # # # . # . # . # # # # # # # . # # # # # # # # # # # # # . # . # # # # # # # . # . # # # # # . # . # # # # # # # . # . # # # . # # # # # . # # # # # . #
# . # . . . # . # . # . # . . . # . . . # . . . . . # . . . # . # . # . . . # . # . # . # . . . # . . . . . . . # . . . . . # . . . . . # . # . . . # . . . . . #
# . # # # . # # # . # . # . # # # # # . # # # . # # # # # . # . # . # # # . # . # . # # # . # # # . # # # # # # # # # . # . # # # . # # # . # # # # # # # . # . #
# . # . . . # . # . . . # . . . . . . . . . . . # . . . . . . . . . . . # . . . . . . . # . # . . . . . # . . . . . . . # . . . # . . . . . # . . . . . . . # . #
# . # . # # # . # # # . # # # . # . # # # . # # # # # # # # # # # # # . # . # # # . # # # # # # # . # # # . # # # . # . # # # # # . # # # # # # # . # # # # # . #
# . . . . . # . # . # . # . # . # . # . # . . . . . . . . . # . . . # . # . . . # . # . . . # . . . # . . . # . . . # . . . # . . . . . . . # . . . # . . . # . #
# # # . # . # . # . # # # . # . # # # . # # # # # . # # # # # # # . # . # . # # # . # # # . # # # . # # # # # # # . # # # . # . # . # # # # # # # # # # # . # . #
# . # . # . . . # . . . # . # . # . . . # . . . . . . . . . # . . . . . # . # . . . # . . . . . # . . . # . . . . . # . # . # . # . . . # . # . . . # . . . # . #
# . # . # # # . # . # # # . # . # # # . # . # # # . # # # # # . # # # # # # # # # . # # # . # . # . # # # . # # # # # . # # # # # . # . # . # . # # # . # . # . #
# . . . # . . . . . . . . . # . # . # . # . # . # . . . # . . . # . . . . . . . . . # . . . # . # . . . # . . . # . # . . . . . . . # . . . # . . . # . # . . . #
# . # # # . # # # . # # # # # # # . # . # . # . # # # # # . # # # # # # # . # . # # # . # . # # # # # # # # # . # . # # # # # # # . # # # . # . # # # . # . # # #
# . # . . . # . . . # . . . . . . . . . # . # . . . # . . . . . . . # . # . # . . . . . # . # . . . . . . . . . . . # . # . . . # . . . # . . . . . # . # . . . #
# # # . # # # . # # # # # # # . # # # # # # # . # . # # # # # # # . # . # . # . # # # . # # # # # # # . # # # # # . # . # # # . # . # # # . # # # # # . # # # # #
# . . . # . . . # . . . # . # . . . # . . . . . # . # . . . . . . . # . . . # . . . # . # . . . # . . . . . # . # . . . # . . . . . # . . . # . . . . . . . # . #
# . # . # . # # # . # # # . # # # . # # # # # . # # # # # . # . # # # . # . # # # # # . # # # . # # # # # . # . # . # . # . # # # # # # # . # # # # # . # . # . #
# . # . # . . . . . # . . . # . # . # . . . # . . . . . # . # . . . # . # . # . . . # . . . # . . . # . . . # . . . # . . . . . # . # . . . . . # . # . # . . . #
# . # . # # # . # # # # # . # . # . # # # . # . # . # # # . # # # . # . # # # . # # # # # # # # # . # # # # # # # # # . # # # . # . # # # # # # # . # . # . # # #
# . # . # . . . # . . . . . . . . . . . # . # . # . # . . . # . . . # . . . # . . . . . # . . . # . # . . . . . . . . . . . # . # . # . # . . . # . . . # . # . #
# . # . # # # . # # # # # . # # # . # . # . # . # . # # # # # # # # # # # . # # # # # . # . # . # . # . # # # # # . # # # . # # # . # . # . # # # . # # # . # . #
# . # . # . . . . . . . . . # . # . # . # . . . # . . . # . . . . . . . . . # . . . # . . . # . . . . . . . # . . . # . . . # . # . . . . . . . # . . . # . . . #
# # # # # # # . # . # # # . # . # # # . # . # # # # # . # . # # # # # # # # # # # . # # # # # # # # # . # # # . # # # . # . # . # . # # # # # . # # # # # # # . #
# . . . # . # . # . . . # . # . . . # . . . . . # . # . # . # . . . . . # . . . # . . . # . . . . . . . # . . . . . # . # . # . # . # . # . . . # . . . . . . . #
# # # . # . # # # # # . # # # . # # # . # # # # # . # . # . # . # # # . # . # # # # # . # # # . # # # # # . # # # # # # # . # . # . # . # # # . # # # # # . # . #
# . # . . . # . # . # . . . . . # . . . . . # . . . # . # . . . . . # . . . . . # . . . # . . . . . # . . . . . . . . . # . # . . . # . # . . . . . # . . . # . #
# . # # # . # . # . # # # # # . # . # # # # # # # . # # # # # # # # # . # # # . # # # . # . # # # # # # # # # # # . # # # # # . # . # . # # # # # . # . # . # # #
# . # . . . # . . . . . . . . . # . . . . . . . . . # . # . # . # . . . . . # . # . . . # . . . # . # . . . . . # . . . # . # . # . # . . . . . . . . . # . # . #
# . # . # . # # # # # # # . # # # # # # # . # # # # # . # . # . # # # # # # # . # . # . # # # . # . # . # # # # # . # # # . # . # # # . # # # # # . # # # . # . #
# . . . # . # . . . . . # . . . # . . . # . # . . . # . # . # . . . . . . . . . # . # . . . # . . . # . # . . . # . . . . . # . . . # . # . . . # . # . . . . . #
# # # . # # # # # . # . # . # . # . # # # # # . # # # . # . # # # . # # # # # # # # # # # . # . # # # . # . # # # # # # # # # # # . # # # # # . # # # # # # # # #
# . . . . . . . . . # . . . # . # . . . # . . . . . . . . . . . . . # . # . . . . . . . . . . . . . . . . . # . . . # . . . . . # . . . # . . . # . . . # . . . #
# # # # # # # . # # # # # . # # # . # # # # # . # # # # # . # # # . # . # . # . # . # . # # # . # . # . # # # # # . # . # # # # # . # . # # # . # . # . # . # # #
# . . . . . . . . . # . # . . . # . . . # . # . . . . . # . # . . . # . . . # . # . # . # . . . # . # . . . . . . . . . . . # . . . # . . . # . . . # . # . . . #
# # # . # # # . # . # . # # # # # # # . # . # . # # # # # # # # # . # . # . # # # # # . # # # . # # # # # # # # # # # # # . # . # . # . # # # # # . # . # # # . #
# . . . . . # . # . . . . . # . . . # . . . . . . . # . . . # . . . # . # . # . . . # . # . . . . . . . . . # . . . # . . . . . # . # . . . . . . . # . . . . . #
# # # . # . # # # # # # # . # . # # # # # # # # # # # # # . # # # . # . # . # . # # # . # . # # # . # . # # # . # # # # # . # # # # # . # . # # # # # . # . # . #
# . . . # . . . . . # . . . # . # . # . . . . . . . . . # . . . . . # . # . # . # . # . # . # . . . # . . . # . # . . . # . . . . . # . # . . . # . # . # . # . #
# . # # # # # # # # # # # # # . # . # # # # # # # . # # # . # # # . # # # . # . # . # # # # # . # . # . # # # . # # # . # # # # # # # . # # # # # . # # # # # . #
# . . . # . # . . . # . . . # . # . # . . . . . # . # . . . . . # . # . . . . . . . # . # . . . # . # . # . # . . . # . # . . . . . # . . . # . . . . . # . # . #
# . # # # . # . # . # . # . # . # . # . # # # # # . # . # # # . # # # # # . # # # . # . # # # # # # # . # . # # # . # . # # # . # . # . # # # . # . # # # . # . #
# . . . . . . . # . # . # . . . . . . . . . # . # . . . . . # . . . # . . . # . # . . . # . # . . . . . # . # . . . . . # . # . # . . . . . . . # . . . . . # . #
# # # # # . # # # . # # # # # . # . # . # # # . # # # . # # # # # # # . # . # . # . # # # . # # # . # . # . # # # # # . # . # # # . # # # # # . # # # . # # # # #
# . . . . . . . # . . . . . # . # . # . # . # . # . . . . . # . . . . . # . # . . . # . . . # . . . # . . . . . # . # . . . # . . . # . # . . . # . # . . . . . #
# # # # # # # # # # # . # # # # # # # . # . # . # . # . # # # # # . # . # . # . # # # . # # # # # # # # # . # # # . # . # # # # # . # . # # # . # . # # # # # # #
# . . . # . . . # . . . . . . . # . . . # . # . . . # . . . # . . . # . # . # . . . . . # . # . . . . . . . # . . . . . . . # . . . . . # . . . . . # . . . # . #
# . # # # # # . # # # . # # # . # . # # # . # # # . # . # . # . # # # # # # # # # # # # # . # . # . # # # # # . # # # # # # # . # # # # # # # # # # # . # # # . #
# . . . . . . . . . . . # . # . # . # . . . # . . . # . # . # . . . . . . . . . . . # . # . . . # . . . # . . . . . # . . . # . . . . . . . . . . . # . . . . . #
# # # . # # # . # # # # # . # # # . # . # . # # # . # # # # # . # # # # # . # # # . # . # . # . # . # # # # # # # . # . # . # . # # # # # # # . # # # . # # # . #
# . . . # . . . # . # . # . # . . . # . # . . . . . . . # . # . # . . . . . . . # . . . # . # . # . # . . . # . . . . . # . . . # . . . # . # . # . . . # . # . #
# # # # # . # # # . # . # . # . # # # # # . # # # . # . # . # # # # # # # . # . # # # # # . # # # # # # # . # . # . # . # # # . # # # . # . # . # # # . # . # . #
# . . . . . . . . . # . # . # . . . # . . . . . # . # . . . . . . . # . . . # . . . # . . . # . # . # . # . . . # . # . # . # . # . . . . . . . # . . . # . . . #
# # # # # . # # # . # . # . # . # # # . # # # # # . # # # . # . # # # # # # # # # . # # # # # . # . # . # # # . # # # . # . # . # . # # # # # # # . # # # # # . #
# . . . # . # . . . . . . . . . . . . . # . . . . . # . . . # . . . # . . . . . # . # . . . # . . . # . . . . . # . # . # . # . # . # . . . # . . . . . # . # . #
# . # # # # # # # # # # # # # . # # # # # . # # # # # # # # # # # . # . # # # . # # # . # # # . # . # . # # # # # . # # # . # # # # # # # . # # # . # . # . # # #
# . . . # . . . # . # . . . . . . . . . # . # . . . . . . . . . . . # . . . # . # . # . . . . . # . . . . . # . # . . . . . # . . . . . # . # . # . # . . . . . #
# # # . # . # # # . # # # . # # # . # # # . # . # . # # # # # . # # # . # . # # # . # # # . # # # # # . # # # . # . # # # # # . # . # # # . # . # # # . # . # # #
# . # . . . . . . . # . # . # . . . # . . . # . # . . . . . # . . . # . # . . . . . . . # . # . . . . . . . . . # . . . # . . . # . . . . . . . # . # . # . . . #
# . # . # . # # # . # . # . # . # . # . # # # . # . # # # # # . # . # # # # # . # # # # # . # # # . # . # # # # # # # . # # # . # # # # # . # # # . # # # . # # #
# . # . # . # . . . . . . . # . # . # . # . # . # . # . . . # . # . # . . . . . . . . . . . . . # . # . # . . . . . . . # . . . # . . . # . . . . . . . . . # . #
# . # . # # # # # . # # # # # # # # # . # . # . # # # . # # # # # # # # # . # # # # # # # # # . # # # # # # # . # # # . # . # # # # # . # # # # # . # . # # # . #
# . . . . . # . . . . . # . . . # . . . . . # . . . # . . . . . . . . . # . . . # . . . . . . . . . # . . . . . . . # . . . . . # . . . . . . . . . # . # . # . #
# # # . # # # # # . # # # . # # # # # . # . # . # # # # # . # # # # # . # . # # # # # # # # # . # # # . # . # . # . # # # . # # # # # # # . # # # . # # # . # . #
# . . . . . . . # . . . . . # . . . . . # . # . . . . . . . # . . . . . . . . . . . . . # . . . . . . . # . # . # . . . # . . . . . . . # . # . . . . . . . . . #
# g # # # # # # # # # # # # # # # # # # # # # # # # # # # # # # # # # # # # # # # # # # # # # # # # # # # # # # # # # # # # # # # # # # # # # # # # # # # # # # #