# # # # # # # # # # # # # # # # # # # # # # # # # # # # # # # # # # # # # # # # # # # # # # # # # # # # # # # # # # # # # # # # # # # # # # # # # # # # # # # # #
g . . . . . . . . . . . . . # . . . # . # . . . . . . . . . # . . . . . # . . . # . # . . . # . . . # . . . . . . . # . . . # . . . . . . . # . . . . . # . . . #
# # # . # . # . # . # . # # # . # # # . # . # # # # # . # # # . # # # # # # # . # . # # # . # . # . # # # # # . # . # # # . # . # . # # # . # . # # # . # . # . #
# . . . # . # . # . # . . . . . . . # . # . # . . . # . # . . . . . . . # . . . . . # . # . . . # . . . # . # . # . . . . . . . # . . . # . . . # . . . # . # . #
# # # # # . # # # . # # # # # # # # # . # . # . # # # . # . # # # . # # # # # # # . # . # . # . # . # . # . # # # # # # # . # # # # # # # # # . # . # # # . # # #
# . . . # . # . . . # . . . . . . . # . . . # . . . . . # . # . . . . . # . . . . . . . # . # . # . # . # . # . . . . . # . # . . . . . . . . . # . # . . . . . #
# . # . # # # . # . # # # . # # # # # . # . # # # # # . # # # # # # # . # . # . # . # # # # # . # # # # # . # . # # # . # . # # # # # # # . # . # . # . # # # . #
# . # . . . . . # . . . # . # . # . . . # . . . . . # . # . . . . . . . . . # . # . # . # . . . # . . . # . . . # . # . . . . . . . . . # . # . # . . . # . . . #
# # # # # # # . # # # . # . # . # # # . # # # # # # # . # . # . # # # # # # # # # # # . # . # . # # # . # . # . # . # # # # # . # . # # # # # . # . # . # # # . #
# . . . # . . . # . # . . . . . # . . . . . # . . . # . # . # . . . . . # . # . . . # . . . # . # . . . . . # . . . # . . . . . # . # . . . . . # . # . # . # . #
# . # # # . # . # . # # # . # # # # # # # . # # # . # . # # # # # . # . # . # . # # # . # # # . # . # . # # # . # . # . # # # # # # # . # # # # # # # . # . # # #
# . . . . . # . . . # . # . . . # . . . . . . . # . # . # . # . . . # . # . . . . . . . . . # . # . # . # . # . # . # . # . # . # . . . # . . . # . . . # . . . #
# . # # # # # . # # # . # # # . # . # . # # # . # . # # # . # . # # # # # . # # # # # . # . # # # # # # # . # . # # # # # . # . # . # . # . # # # . # . # # # . #
# . # . . . . . . . # . . . . . # . # . # . . . . . . . . . . . . . . . . . # . . . . . # . # . . . # . # . . . # . . . . . . . # . # . # . . . . . # . . . . . #
# # # . # # # . # # # # # . # # # . # # # # # . # . # # # # # . # # # # # # # # # . # # # # # . # # # . # # # . # . # # # . # # # # # . # . # . # # # # # . # # #
# . . . # . . . . . . . # . # . # . # . # . . . # . . . . . # . # . . . . . . . # . . . # . . . . . . . # . . . . . # . . . # . # . . . # . # . . . . . # . . . #
# . # . # . # # # # # # # . # . # # # . # # # . # # # # # . # . # # # . # # # # # # # . # . # . # # # # # # # . # # # # # # # . # . # # # . # # # # # # # # # # #
# . # . # . # . . . . . # . # . . . # . . . . . . . . . # . # . # . # . . . # . . . . . . . # . . . # . . . # . . . # . . . . . . . # . . . . . # . # . # . # . #
# . # # # . # # # . # # # . # . # . # # # # # # # # # # # # # . # . # . # # # # # . # . # . # . # # # . # . # # # # # # # . # . # . # . # # # . # . # . # . # . #
# . # . # . . . # . # . . . . . # . . . # . . . . . # . # . # . . . . . # . . . . . # . # . # . . . # . # . . . # . # . . . # . # . # . . . # . . . . . . . . . #
# . # . # # # . # . # # # # # . # . # # # . # # # # # . # . # . # . # # # . # # # # # # # . # . # # # # # # # . # . # # # # # . # # # . # # # # # # # . # . # . #
# . . . # . # . # . . . # . # . # . . . . . # . # . . . # . # . # . # . # . # . # . # . # . # . . . . . . . # . . . . . . . . . # . # . # . . . # . . . # . # . #
# . # . # . # # # # # . # . # # # . # # # . # . # . # # # . # . # . # . # # # . # . # . # # # # # # # . # # # # # # # . # . # . # . # # # . # . # # # . # # # . #
# . # . # . # . . . # . . . . . # . # . # . # . . . . . . . . . # . # . . . # . # . # . . . # . # . . . # . . . # . # . # . # . . . . . # . # . . . # . # . # . #
# . # . # . # # # . # . # . # . # . # . # . # # # . # # # . # # # . # # # . # . # . # # # . # . # . # # # # # . # . # # # # # # # . # # # # # . # # # # # . # . #
# . # . . . # . # . . . # . # . # . # . . . # . . . . . # . # . . . . . # . . . . . . . . . . . . . . . # . # . . . . . # . . . . . . . # . # . # . . . . . . . #
# . # # # . # . # . # # # # # # # # # # # # # # # # # # # . # # # # # # # . # # # # # . # # # # # # # # # . # . # # # . # . # # # . # # # . # . # # # # # . # # #
# . . . # . . . # . . . . . . . # . . . # . . . . . # . . . . . . . . . # . . . . . # . . . # . . . . . . . # . # . . . . . . . # . . . # . . . . . # . . . . . #
# . # # # # # . # . # # # # # . # # # . # # # # # . # # # . # # # . # . # # # # # # # . # # # # # # # # # . # # # # # # # . # # # # # . # # # # # . # . # # # . #
# . . . # . # . # . . . # . . . . . # . # . . . # . . . . . . . # . # . # . # . # . . . . . # . . . . . . . # . . . . . . . . . # . . . . . . . . . # . # . . . #
# # # # # . # . # . # . # # # . # # # . # . # . # . # # # # # # # . # # # . # . # # # . # . # # # . # # # # # . # # # . # . # # # # # # # . # # # # # . # # # # #
# . # . . . . . . . # . # . . . . . . . # . # . # . . . # . . . . . # . # . . . . . . . # . . . . . . . # . # . # . . . # . . . # . # . . . . . # . # . . . . . #
# . # # # # # . # # # # # . # . # # # # # # # . # . # . # # # # # # # . # # # . # # # # # # # . # # # . # . # # # # # . # . # # # . # # # . # # # . # . # # # # #
# . . . . . # . # . # . # . # . # . # . . . . . # . # . # . # . # . . . # . . . # . # . . . . . . . # . . . . . # . . . # . . . # . . . . . # . . . . . . . . . #
# # # # # . # . # . # . # . # . # . # . # # # . # . # # # . # . # . # . # # # . # . # # # . # # # # # # # # # . # # # # # # # # # . # # # . # # # # # . # # # . #
# . # . . . . . # . . . # . # . # . . . . . # . # . . . # . . . # . # . . . # . # . . . . . # . . . # . # . . . # . . . . . # . . . . . # . # . . . . . # . . . #
# . # # # # # # # . # # # . # # # . # # # # # # # # # # # # # . # . # # # # # # # . # # # . # # # . # . # # # # # # # . # # # . # . # . # # # # # . # # # . # . #
# . . . . . . . . . # . . . # . # . . . . . # . . . . . # . # . . . . . # . . . # . . . # . . . . . # . . . . . . . . . . . # . # . # . # . # . # . # . . . # . #
# . # # # . # . # . # . # # # . # . # # # # # # # # # . # . # # # . # # # # # . # . # # # # # . # # # # # . # # # . # . # . # . # # # # # . # . # . # # # # # . #
# . # . . . # . # . # . . . . . . . . . . . . . # . # . # . . . . . . . # . # . . . . . # . . . # . . . . . . . # . # . # . # . . . . . # . . . . . # . # . . . #
# # # # # # # # # . # # # . # . # . # # # . # # # . # . # . # # # # # # # . # . # # # . # # # . # . # # # . # # # # # . # # # # # # # . # # # # # # # . # # # . #
# . . . . . . . . . # . . . # . # . # . # . # . . . . . . . # . # . . . # . . . . . # . # . . . # . # . . . . . . . # . . . # . . . . . . . . . # . . . # . . . #
# . # # # # # . # # # . # # # # # . # . # # # # # # # # # . # . # . # # # . # . # # # # # # # . # . # . # # # # # # # . # . # # # . # # # . # # # . # # # . # # #
# . . . # . . . . . . . # . . . . . . . # . . . . . . . # . . . # . # . . . # . # . . . # . . . . . # . . . # . # . . . # . # . . . . . # . . . . . . . # . . . #
# # # # # . # . # # # # # # # # # # # # # . # # # . # # # # # . # . # # # . # # # . # # # # # # # . # # # . # . # # # . # # # # # . # # # # # . # . # . # # # # #
# . . . . . # . . . . . # . . . . . # . . . # . . . . . . . . . . . # . . . # . . . . . # . # . # . # . . . . . . . # . . . . . . . . . # . . . # . # . # . # . #
# # # . # # # # # . # # # # # # # . # # # # # # # # # # # # # # # . # . # # # . # . # . # . # . # # # # # . # . # # # # # # # # # # # . # # # . # . # # # . # . #
# . . . . . . . # . . . . . # . . . # . # . # . # . # . . . # . # . # . . . . . # . # . . . # . . . . . . . # . . . . . # . # . # . . . . . # . # . # . # . . . #
# # # . # # # # # . # . # . # . # . # . # . # . # . # . # # # . # . # # # # # . # # # # # # # # # . # # # . # # # . # # # . # . # # # # # . # # # # # . # . # # #
# . . . # . # . . . # . # . . . # . # . . . . . # . . . . . # . # . . . . . . . # . . . # . . . # . . . # . # . . . . . . . . . # . . . . . . . # . . . # . . . #
# . # # # . # # # # # # # . # . # . # # # # # . # # # # # . # . # # # # # . # # # . # # # # # . # # # . # # # # # # # # # # # # # . # # # . # . # . # . # . # . #
# . # . . . . . . . . . # . # . # . # . # . . . . . # . # . . . # . . . # . . . . . . . . . . . # . . . # . . . . . # . . . . . # . # . # . # . . . # . # . # . #
# # # . # . # . # . # # # # # # # . # . # # # . # . # . # # # . # . # # # # # . # # # . # # # . # # # # # . # # # # # # # # # . # # # . # . # # # # # # # # # . #
# . . . # . # . # . . . # . . . # . . . . . . . # . . . # . . . . . . . . . . . # . . . # . . . . . . . . . # . . . # . . . . . # . # . . . # . . . . . # . . . #
# # # # # # # . # # # # # # # . # . # # # # # . # # # . # . # # # . # # # # # . # # # . # . # . # # # . # # # . # . # . # # # # # . # # # # # . # . # . # . # # #
# . # . # . . . . . # . . . . . # . . . # . . . # . # . . . # . . . # . . . # . . . # . # . # . # . . . . . # . # . # . . . . . . . . . # . . . # . # . # . # . #
# . # . # # # # # . # # # # # . # # # # # . # # # . # # # . # # # # # # # . # # # # # # # # # . # # # . # # # # # . # . # # # # # # # # # . # # # . # # # . # . #
# . . . . . . . # . # . . . . . # . # . . . # . . . . . . . # . # . . . # . # . . . . . # . # . # . # . # . . . # . . . . . . . . . # . . . . . # . . . # . . . #
# . # # # . # # # . # . # # # . # . # . # . # # # # # . # # # . # # # . # . # # # . # # # . # # # . # # # # # . # . # # # # # . # # # # # . # . # # # . # . # . #
# . . . # . . . . . . . . . # . . . # . # . . . # . . . # . . . . . # . . . . . . . # . . . # . . . # . . . . . . . # . . . . . . . . . # . # . # . . . . . # . #
# . # # # # # # # # # . # # # . # . # . # # # . # # # # # . # . # # # . # . # # # . # # # . # # # . # # # # # # # . # # # . # # # # # # # # # . # # # # # # # . #
# . . . # . # . # . . . # . # . # . # . # . # . # . . . . . # . . . # . # . . . # . # . . . # . . . . . # . . . . . . . # . # . . . # . . . # . . . . . # . # . #
# # # # # . # . # . # . # . # # # . # . # . # . # . # . # # # # # # # # # . # # # . # # # . # # # . # . # . # . # . # # # . # # # . # # # . # # # # # . # . # # #
# . . . # . # . . . # . . . # . . . . . # . . . . . # . . . # . . . . . # . . . # . . . . . # . . . # . # . # . # . # . . . . . . . . . . . # . . . . . # . . . #
# # # . # . # . # # # . # # # . # . # # # . # # # # # # # . # . # # # . # . # # # # # . # # # . # # # # # . # . # # # # # . # # # . # . # # # # # . # . # . # # #
# . . . . . # . # . . . # . # . # . . . # . . . # . # . . . # . # . . . . . . . # . . . . . . . # . . . # . # . . . # . . . . . # . # . . . . . . . # . . . # . #
# . # # # # # # # # # # # . # . # # # # # # # . # . # # # . # # # . # . # . # . # # # # # # # . # . # # # . # . # # # . # # # # # . # # # # # # # # # # # . # . #
# . . . . . . . . . . . . . # . # . . . . . # . . . # . . . . . . . # . # . # . # . # . . . . . . . # . # . # . . . # . # . # . # . . . # . . . . . # . . . . . #
# # # . # # # # # . # . # # # . # . # . # . # . # # # # # # # # # . # . # . # . # . # # # . # # # . # . # . # . # . # # # . # . # . # # # # # . # # # . # # # . #
# . . . . . # . # . # . . . # . . . # . # . # . # . . . # . . . # . # . # . # . # . . . . . # . . . # . # . # . # . # . # . . . . . . . # . . . . . . . . . # . #
# . # # # # # . # # # . # # # . # . # # # # # # # # # . # . # # # # # . # # # # # . # # # # # . # # # . # # # . # # # . # . # # # # # . # # # # # . # # # . # . #
# . # . # . . . # . # . # . # . # . . . # . . . . . . . . . . . . . # . . . . . # . # . . . # . . . . . # . # . . . # . . . # . . . # . . . # . . . . . # . # . #
# . # . # . # # # . # . # . # # # # # . # # # # # . # . # # # # # # # . # . # # # # # . # # # . # # # . # . # # # # # # # # # . # # # # # # # # # # # . # # # # #
# . # . . . . . . . . . # . . . # . . . . . . . # . # . # . . . . . . . # . # . . . # . . . # . # . # . . . . . . . # . . . . . . . # . . . . . . . . . # . . . #
# . # . # # # # # # # # # # # . # . # # # . # # # # # . # . # # # # # # # . # . # # # . # # # # # . # . # . # . # # # # # # # . # . # . # # # # # # # # # . # # #
# . # . . . . . # . . . # . . . . . # . . . # . # . . . # . . . . . # . # . . . # . . . . . # . . . # . # . # . . . . . . . . . # . # . . . . . # . . . # . . . #
# # # . # # # # # # # . # . # # # # # . # . # . # # # . # # # # # . # . # # # . # # # # # . # . # # # # # . # # # # # # # . # # # . # # # # # . # # # . # # # . #
# . # . . . . . . . . . # . # . # . # . # . . . # . . . . . # . . . . . . . # . # . # . . . # . . . # . . . . . # . . . . . # . . . # . # . . . . . . . # . . . #
# . # . # # # # # # # . # . # . # . # . # . # . # . # # # # # # # . # # # . # # # . # . # . # . # # # # # # # # # . # . # . # . # # # . # # # . # . # . # . # . #
# . . . . . # . . . . . . . # . . . . . # . # . # . . . . . . . . . # . . . . . . . . . # . . . # . . . . . . . . . # . # . # . . . . . . . . . # . # . . . # . s
# # # # # # # # # # # # # # # # # # # # # # # # # # # # # # # # # # # # # # # # # # # # # # # # # # # # # # # # # # # # # # # # # # # # # # # # # # # # # # # # #