# # # # # # # # # # # # # # # # # # # # # # # # # #
s . . . . # . . . . # . . . . # . . . . # . . . . #
# . # # . # . # # . # . # # . # . # # . # . # # . #
# . . . . . . . . . . . . . . . . . . . . . . . . #
# # # . # # # . # # # . # # # . # # # . # # # . # #
# . . . . # . . . . # . . . . # . . . . # . . . . #
# . # # . # . # # . # . # # . # . # # . # . # # . #
# . . . . . . . . . . . . . . . . . . . . . . . . #
# # # . # # # . # # # . # # # . # # # . # # # . # #
# . . . . # . . . . # . . . . # . . . . # . . . . #
# . # # . # . # # . # . # # . # . # # . # . # # . #
# . . . . . . . . . . . . . . . . . . . . . . . . #
# # # . # # # . # # # . # # # . # # # . # # # . # #
# . . . . # . . . . # . . . . # . . . . # . . . . #
# . # # . # . # # . # . # # . # . # # . # . # # . #
# . . . . . . . . . . . . . . . . . . . . . . . . #
# # # . # # # . # # # . # # # . # # # . # # # . # #
# . . . . # . . . . # . . . . # . . . . # . . . . #
# . # # . # . # # . # . # # . # . # # . # . # # . #
# . . . . . . . . . . . . . . . . . . . . . . . . #
# # # . # # # . # # # . # # # . # # # . # # # . # #
# . . . . # . . . . # . . . . # . . . . # . . . . #
# . # # . # . # # . # . # # . # . # # . # . # # . #
# . . . . . . . . . . . . . . . . . . . . . . . . #
# # # # # # # # # # # # # # # # # # # # # # # # g #