# # # # # # # # # # # # # # # # # # # # #
s . . . . . # . . . # . . . . . . . . . #
# # # # # . # . # . # # # # # # # # # . #
g . . . # . . . # . # . . . . . . . . . #
# # # . # # # # # . # . # # # # # # # . #
# . . . # . . . # . . . # . # . . . # . #
# . # . # # # . # # # # # . # . # . # . #
# . # . . . . . # . . . # . . . # . # . #
# . # # # # # . # . # . # . # # # . # . #
# . . . # . . . . . # . # . . . # . . . #
# # # . # . # # # # # # # # # . # # # # #
# . . . # . # . . . . . . . # . # . . . #
# . # # # # # . # # # . # # # . # . # . #
# . . . . . # . . . # . . . # . # . # . #
# # # # # . # # # . # # # . # . # . # . #
# . . . . . . . # . # . # . # . # . # . #
# . # # # # # # # . # . # . # . # . # # #
# . # . . . # . . . # . # . . . # . . . #
# . # . # . # . # # # . # # # # # # # . #
# . . . # . . . . . . . . . . . . . . . #
# # # # # # # # # # # # # # # # # # # # #