# # # # # # # # # # # # # # # # # # # # # # # # # # # # # # # # # # # # # # # # #
s . . . # . . . . . . . . . . . . . . . . . . . # . . . . . . . # . # . . . . . #
# . # # # . # # # # # # # . # # # # # . # . # . # # # . # . # . # . # # # # # . #
# . . . # . . . # . # . # . # . . . # . # . # . . . . . # . # . . . . . . . . . #
# # # . # # # . # . # . # . # . # . # # # # # # # . # . # # # # # # # . # # # . #
# . . . . . . . . . # . # . # . # . # . . . . . # . # . # . . . . . . . . . # . #
# . # . # # # # # . # . # . # . # # # . # # # # # # # # # . # # # # # . # . # # #
# . # . # . . . . . # . . . # . . . # . . . . . . . # . # . # . # . . . # . # . #
# # # # # # # . # # # # # # # # # . # . # # # . # # # . # # # . # # # . # . # . #
# . . . . . # . . . . . . . . . # . . . # . . . . . . . . . # . . . . . # . . . #
# # # # # . # # # # # # # # # # # . # # # # # . # # # # # . # # # . # # # # # # #
# . . . . . . . . . . . # . . . # . # . . . . . # . . . # . # . . . . . # . # . #
# # # . # # # # # # # . # # # . # . # . # # # . # # # . # # # # # . # # # . # . #
# . . . # . . . # . . . . . # . . . # . . . # . . . # . . . . . . . # . # . # . #
# . # . # . # . # # # . # # # # # # # . # # # . # # # # # # # # # . # . # . # . #
# . # . . . # . # . . . # . . . . . # . # . . . . . # . # . . . . . . . . . . . #
# . # . # # # # # # # # # . # # # # # . # # # . # # # . # # # . # # # # # . # # #
# . # . # . # . . . # . # . . . . . # . . . # . . . . . . . . . . . # . # . . . #
# . # . # . # # # . # . # # # . # . # # # . # # # # # # # # # . # . # . # . # # #
# . # . . . # . # . . . # . . . # . # . . . . . . . . . # . . . # . # . # . . . #
# . # . # # # . # . # # # . # . # # # # # # # # # . # # # # # . # # # . # . # . #
# . # . . . # . . . # . # . # . # . . . # . # . . . # . . . . . . . # . # . # . #
# # # . # . # # # . # . # # # . # . # . # . # # # # # # # . # # # . # . # # # . #
# . . . # . . . # . # . . . . . # . # . . . . . # . # . . . . . # . . . # . . . #
# . # # # # # . # . # # # . # . # . # # # . # # # . # # # . # # # . # # # # # # #
# . . . # . . . . . . . . . # . . . # . . . # . # . . . # . # . # . . . # . # . #
# # # . # # # # # . # . # . # # # # # # # # # . # # # . # . # . # . # . # . # . #
# . . . # . . . . . # . # . . . # . # . . . . . . . . . . . . . # . # . # . . . #
# . # . # # # . # # # . # # # . # . # # # # # # # . # . # . # . # # # . # . # # #
# . # . # . . . . . # . # . . . . . # . . . # . . . # . # . # . # . . . # . . . #
# . # # # # # # # . # # # . # . # . # # # . # . # # # # # # # . # . # # # . # # #
# . # . . . # . . . # . . . # . # . . . # . # . . . # . . . . . # . . . . . . . #
# # # # # . # # # . # # # # # # # . # # # . # . # # # . # # # . # # # # # # # . #
# . . . . . # . . . . . # . . . . . . . . . . . # . . . # . . . . . . . . . # . #
# # # . # # # # # . # # # # # . # . # . # # # # # # # # # . # . # # # # # . # # #
# . . . . . . . . . . . # . . . # . # . . . . . # . . . # . # . . . # . # . # . #
# # # # # # # # # # # # # # # . # # # . # # # # # . # # # # # # # # # . # . # . #
# . . . . . # . . . . . . . # . . . # . . . . . . . # . . . # . . . . . # . . . #
# . # . # # # # # # # # # . # # # # # . # # # . # . # # # . # # # . # # # . # . #
# . # . . . . . . . . . . . . . . . . . # . . . # . . . . . . . . . . . . . # . #
# g # # # # # # # # # # # # # # # # # # # # # # # # # # # # # # # # # # # # # # #