# s # # # # # # # # # # # # # # # # # # #
# . . . . . # . . . # . . . . . . . . . #
# # # # # . # . # . # # # # # # # # # . #
# . . . # . . . # . # . . . . . . . . . #
# # # . # # # # # . # . # # # # # # # . #
# . . . # . . . # . . . # . # . . . # . #
# . # . # # # . # # # # # . # . # . # . #
# . # . . . . . # . . . # . . . # . # . #
# . # # # # # . # . # . # . # # # . # . #
# . . . # . . . . . # . # . . . # . . . #
# # # . # . # # # # # # # # # . # # # # #
# . . . # . # . . . . . . . # . # . . . #
# . # # # # # . # # # . # # # . # . # . #
# . . . . . # . . . # . . . # . # . # . #
# # # # # . # # # . # # # . # . # . # . #
# . . . . . . . # . # . # . # . # . # . #
# . # # # # # # # . # . # . # . # . # # #
# . # . . . # . . . # . # . . . # . . . #
# . # . # . # . # # # . # # # # # # # . #
g . . . # . . . . . . . . . . . . . . . #
# # # # # # # # # # # # # # # # # # # # #