# # # # # # # # # # # # # # # # # # # # # # # # # # #
# . . . . . . . . . . . . . . . . . . . . . . . . . #
# . # # # # # # # # # # # # # # # # # # # # # # # . #
# . # . . . . . . . . . . . . . . . . . . . . . # . #
# . # . # # # # # # # # # . # # # # # # # # # . # . #
# . # . # . . . . . . . . . . . . . . . . . # . # . #
# . # . # . # # # # # # # # # # # # # # # . # . # . #
# . # . # . # . . . . . . . . . . . . . # . # . # . #
# . # . # . # . # # # # # # # # # # # . # . # . # . #
# . # . # . # . # . . . . . . . . . # . # . # . # . #
# . # . # . # . # . # # # # # # # . # . # . # . # . #
# . # . # . # . # . # . . . . . # . # . # . # . # . #
# . # . # . # . # . # . # . # . # . # . # . # . # . #
# . . . # . # . # . . . # g # . # . # . . . # . # . #
# . # . # . # . # . # . # # # . # . # . # . # . # . #
# . # . # . # . # . # . . . . . # . # . # . # . # . #
# . # . # . # . # . # # # # # # # . # . # . # . # . #
# . # . # . # . # . . . . . . . . . # . # . # . # . #
# . # . # . # . # # # # # . # # # # # . # . # . # . #
# . # . # . # . . . . . . . . . . . . . # . # . # . #
# . # . # . # # # # # # # # # # # # # # # . # . # . #
# . # . # . . . . . . . . . . . . . . . . . # . # . #
# . # . # # # # # # # # # # # # # # # # # # # . # . #
# . # . . . . . . . . . . . . . . . . . . . . . # . #
# . # # # # # # # # # # # # # # # # # # # # # # # . #
# . . . . . . . . . . . . . . . . . . . . . . . . . #
# # # # # # # # # # # # # s # # # # # # # # # # # # #