# # # # # # # # # # # # # # # # # # # # # # # # #
# . . . . . . . . . . . . . . . . . . . . . . . #
# . # # # # # # # # # # # # # # # # # # # # # . #
# . # . . . . . . . . . . . . . . . . . . . # . #
# . # . # # # # # # # # # # # # # # # # # . # . #
# . # . # . . . . . . . . . . . . . . . # . # . #
# . # . # . # # # # # # # # # # # # # . # . # . #
# . # . # . # . . . . . . . . . . . # . # . # . #
# . # . # . # . # # # # # # # # # . # . # . # . #
# . # . # . # . # . . . . . . . # . # . # . # . #
# . # . # . # . # . # # # # # . # . # . # . # . #
# . # . # . # . # . # g . . # . # . # . # . # . #
# . # . # . # . # . # # # . # . # . # . # . # . #
# . # . # . # . # . . . . . # . # . # . # . # . #
# . # . # . # . # # # # # # # . # . # . # . # . #
# . # . # . # . . . . . . . . . # . # . # . # . #
# . # . # . # # # # # # # # # # # . # . # . # . #
# . # . # . . . . . . . . . . . . . # . # . # . #
# . # . # # # # # # # # # # # # # # # . # . # . #
# . # . . . . . . . . . . . . . . . . . # . # . #
# . # # # # # # # # # # # # # # # # # # # . # . #
# . . . . . . . . . . . . . . . . . . . . . # . #
# # # # # # # # # # # # # # # # # # # # # # # s #