# s # # # # # # # # # # # # # # # # # # # # # # # #
# . . . # . . . # . . . . . . . . . # . . . # . . #
# . # . # . # . # . # . # # # # . # . # . # . # . #
# . . . . . . . . . . . . . . . . . . . . . . . . #
# # # . # # # . # # # . # # # . # # # . # # # . # #
# . . . . . . . . . . . . . . . . . . . . . . . . #
# . # . # . # . # . # . # # # # . # . # . # . # . #
# . . . # . . . # . . . . . . . . . # . . . # . . #
# # # # # # # # # # # # # # # # # # # # # # # # . #
# . . . . . . . . . . . . . . . . . . . . . . . . #
# . # . # . # . # . # . # # # # . # . # . # . # . #
# . . . . . . . . . . . . . . . . . . . . . . . . #
# . # . # . # . # . # . # # # # . # . # . # . # . #
# . . . . . . . . . . . . . . . . . . . . . . . . #
# # # . # # # . # # # . # # # . # # # . # # # . # #
# . . . . . . . . . . . . . . . . . . . . . . . . #
# . # . # . # . # . # . # # # # . # . # . # . # . #
# . . . . . . . . . . . . . . . . . . . . . . . . #
# . # # # # # # # # # # # # # # # # # # # # # # # #
# . . . # . . . # . . . . . . . . . # . . . # . . #
# . # . # . # . # . # . # # # # . # . # . # . # . #
# . . . . . . . . . . . . . . . . . . . . . . . . #
# # # . # # # . # # # . # # # . # # # . # # # . # #
# . . . . . . . . . . . . . . . . . . . . . . . . g
# # # # # # # # # # # # # # # # # # # # # # # # # #