# # s # # # # # # # # # # # # # # # # # # # # # # #
# . . . . # . . . # . . . # . . . # . . . # . . . #
# . # # . # . # # . # # . # # . # # . # # . # # . #
# . . . . . . . . . . . . . . . . . . . . . . . . #
# # . # # # . # # # . # # # . # # # . # # # . # # #
# . . . . . . . . . . . . . . . . . . . . . . . . #
# . # # # . # # # . # # # . # # # . # # # . # # # #
# . . . . . . . . . . . . . . . . . . . . . . . . #
# # # . # # # . # # # . # # # . # # # . # # # . # #
# . . . . . . . . . . . . . . . . . . . . . . . . #
# . # # # . # # # . # # # . # # # . # # # . # # # #
# . . . . . . . . . . . . . . . . . . . . . . . . #
# # . # # # . # # # . # # # . # # # . # # # . # # #
# . . . . . . . . . . . . . . . . . . . . . . . . #
# . # # # . # # # . # # # . # # # . # # # . # # # #
# . . . . . . . . . . . . . . . . . . . . . . . . #
# # . # # # . # # # . # # # . # # # . # # # . # # #
# . . . . . . . . . . . . . . . . . . . . . . . . #
# . # # # . # # # . # # # . # # # . # # # . # # # #
# . . . . . . . . . . . . . . . . . . . . . . . . #
# # # . # # # . # # # . # # # . # # # . # # # . # #
# . . . . . . . . . . . . . . . . . . . . . . . . #
# # # # # # # # # # # # # # # # # # # # # # # # g #